#######################################################
#           #                           #             #
#         ###          #                #             #
######                 #                #       #     #
#         ########     ###        ###   ####   ###    #
#                      #          #             #     #
#  ####                #     ######                   #
#     #      #####     #     #            #           #
#     #      #         #     ######       #     ##    #
#            #                            #     #     #
######    #####                      #    #  ##########
#             #       #####          #                #
#             #           #    #######                #
#     ####            #####          #   ####   #     #
#        #        #                  #   #      ##### #
#        #        #  	                 #            #
#  ###   #        ######       #    #    #            #
#    #        #        #       ######         #   #   #
#    #        #        #  #    #    #         #   #   #
#  ###        #    #   ####    #    ######    #   #   #
#        ######    #                          #       #
#                  #                          #       #
#######################################################
